福寿膏=阿芙蓉
姨妈=阿姨
悲伤=哀痛
靠拢=挨近
尊崇=爱崇
敬服=爱惜
布置=安插
稳固=安定
固若金汤=安如泰山
安居乐业=安身立命
照例=按例
推拿=按摩
抑制=按捺
定期=按期
天昏地暗=暗无天日
陈腔滥调=八股
稀奇古怪=八怪七喇
八竿子打不着=八棍子撂不着
八面玲珑=八面见光
四面楚歌=八面受敌
渴望=巴望
翦绺=扒手
合家=百口
鸭蛋虽密也有缝=百密一疏
大惑不解=百思不解
童言无忌=百无禁忌
视为心腹=百依百顺
百折不回=百折不挠
搬迁=搬家
挑拨离间=搬弄是非
邦畿=版图
措施=办法
服务=办事
办好=办妥
豆剖瓜分=半壁江山
中途=半途
欲言又止=半吐半吞
将信将疑=半信半疑
东床=半子
陪同=伴随
包揽=包办
推荐=保举
狂风=暴风
罪恶滔天=暴戾恣睢
袒露=暴露
暴动=暴乱
背信=背约
受宠若惊=被宠若惊
受骗=被骗
当选=被选
相比=比拟
比岁不登=比年不登
角逐=比赛
指手画脚=比手划脚
交锋=比武
青天=彼苍
字迹=笔迹
条记=笔记
翰墨=笔墨
笔挺=笔直
恭恭敬敬=必恭必敬
一定=必然
必须=必需
须要=必要
终究=毕竟
一举而竟全功=毕其功于一役
终生一生没世=毕生
缄口=闭口
杜门不出=闭门不出
凭空捏造=闭门造车
解散=闭幕
葱茏=碧绿
白种人=碧眼儿
避讳=避忌
边疆=边陲
相貌=边幅
疆域=边境
边沿=边缘
主笔=编缉
纪年=编年
体例=编制
编辑=编纂
推动=鞭策
鞭笞=鞭挞
燕服=便服
各处=遍地
暴露=表露
醉翁之意=别有用心
新奇=别致
来宾=宾客
宾朋迎门=宾朋盈门
屏弃=摈弃
酷寒=冰冷
叛乱=兵变
师出无名=兵出无名
军多将广=兵多将广
艨艟=兵舰
武器=兵器
兵法=兵书
承袭=秉承
垂死=病笃
全愈=病愈
医院=病院
颠簸=波动
波涛=波澜
汹涌澎湃=波澜壮阔
否极必泰=剥极必复
吸血虫=剥削者
驳斥=驳倒
靠岸=泊岸
停车=泊车
来路货=舶来品
赢得=博得
展览会=博览会
未便=不便
鄙人=不才
不可=不成
不长进=不成材
有失体统=不成体统
从容不迫=不迟不疾
不辞劳苦=不辞劳怨
不搭腔=不答腔
不打不成相与=不打不相识
不作数=不当准
天诛地灭=不得善终
不合错误=不对
铁价=不二价
不二=不贰
非法=不法
非凡=不凡
难分轩轾=不分高下
不够=不敷
吞声忍气=不敢则声
道貌岸然=不苟言笑
未入流=不够格
不分皁白=不顾曲直
分歧=不合
未几=不久不多
不顾外表=不拘小节
未定=不决
多如牛毛=不可偻指算
不计其数=不可胜数
咄咄逼人=不可一世
烦懑=不快
不郎不秀=不稂不莠
不睬=不理
倒霉=不利
不惜=不吝
不吝指教=不吝珠玉
不留神=不留心
不见圭角=不露锋芒
不露锋芒=不露圭角
不露神色=不露声色
稳定=不乱
不落窠臼=不落俗套
未免=不免难免
不克不及=不能
不能尽数=不能胜数
欲罢不能=不能自休
不能自已=不能自制
不宁不奈=不宁奈
不宁不耐=不宁耐
数奇=不偶
中庸之道=不偏不倚
不平=不屈
否则=不然
冰清玉洁=不染纤尘
惠而不费=不伤脾胃
不堪=不胜
不乏其人=不胜枚举
时时=不时
不识一丁=不识之无
不吃烟火食=不食人间烟火
不伏手=不顺手
不绝=不停
差别=不同
与众不同=不同凡响
不过=不外
有良心=不忘本
不夺农时=不违农时
不唯=不惟
吊儿郎当=不务正业
囚首垢面=不修边幅
观=不雅
不雅=不雅观
不问可知=不言而喻
不厌其详=不厌求详
纷歧=不一
尽心尽力=不遗余力
不消=不用
毋须着急=不用着急
不料=不虞
不肯=不愿
不谋而合=不约而同
永远贬抑=不再任用
未曾=不曾
不伦不类=不正经
不翼而飞=不知去向
不但=不只
不入耳=不中听
不敷=不足
不足齿数=不足挂齿
无足挂齿=不足介意
不足为据=不足为凭
背景=布景
布疋=布匹
微时之交=布衣之交
行动=步履
追随骥尾=步人后尘
步辇儿=步行
步调=步骤
步兵=步卒
队伍=部队
部分=部门
残余=残存
九牛一毛=沧海一粟
惨白=苍白
苍茫=苍莽
存身=藏身安身
图书馆=藏书楼
马虎=草率
杯弓蛇影=草木皆兵
喽啰=草头神
芒鞋=草鞋
并日而食=草衣木食
草野=草泽
侧丽=侧艳
草纸=厕纸
考试=测验
尝试=测验考试
接应=策应
不足为奇=层见迭出
核办=查办
检察=查看
茶楼=茶肆
查访=察访
贪嘴=馋嘴
孕育发生=产生
产品=产物
财产=产业
拔除=铲除
永日=长日
永生=长生
永劫=长时
长眠=长逝
浩叹=长叹
多财善贾=长袖善舞
永夜=长夜
善于=长于
对天长叹=长吁短叹
父老=长者
宗子=长子
一叶知秋=尝鼎一
枕戈待旦=常备不懈
老例=常例
凡人=常人
平日=常日
知识=常识
园地=场地
局面=场合排场
局势=场面地步
场合=场所
洞开=敞开
开怀=畅怀
各抒己见=畅所欲言
流通=畅通流畅
无阻畅通=畅通无阻
兴旺=畅旺
脱销=畅销
痛饮=畅饮
剽窃=抄袭
凌驾=超出
高出=超过跨过
超等=超级
卓荦不群=超绝群伦
轶群=超群
超群出众=超群绝伦
逸群绝俗=超群脱俗
唇亡齿寒=巢倾卵破
进取=朝上进步
向阳=朝阳
后退=撤退退却
大澈大悟=澈底觉悟
灰尘=尘埃
红尘=尘凡
尘事=尘务
托病=称疾
称呼=称谓
玉成=成全
杀身成仁=成仁取义
谋事在人=成事在人
整天=成天
羽化=成仙
匠意于心=成竹在胸
承继=承袭
承上启下=承先启后
老实=诚恳
诚笃=诚实
恳切=诚心
搭车=乘车
搭客=乘客
趁机=乘隙
攻其不备=乘虚而入
惩治=惩办
惩办=惩处
劝善=惩恶
处罚=惩罚
尊师重道=程门立雪
饮茶=吃茶品茗
服法=吃法
用饭=吃饭
急急=吃紧
受惊=吃惊
亏损=吃亏
不识时务=吃米不知米价
胡思乱想=痴心妄想
减刑=弛刑
沼泽=池沼
痴钝=迟钝
缓慢=迟缓
踌躇=迟疑
当机不断=迟疑不决
长期=持久
尸位素餐=持禄
始终如一=持之以恒
掌上河山=尺幅千里
函牍=尺素
革退=斥退
羞辱=赤诚
红军=赤军
血色=赤色
忠肝义胆=赤血丹心
小儿百姓=赤子
党羽=翅膀
置之不理=充耳不闻
撑场面=充排场
充当=充任
满盈=充塞
凑数=充数
充斥=充溢
丰裕=充盈
充分=充裕
冒犯=冲克
洗沐=冲凉
突破=冲破
突入=冲入
冲洗=冲刷
昆虫=虫豸
崇敬=崇拜
信仰=崇奉
敌视=仇视
中怀怨恨=仇隙在心
缱绻=绸缪
满腹忧愁=愁肠百结
哀肠百转=愁肠寸断
没精打彩=愁眉苦脸
愁眉苦脸=愁眉锁眼
于归之喜=出阁之喜
行踪飘忽=出没无定
出谋划策=出谋献策
有缺=出缺
出人意表=出人意料
精彩=出色
入迷=出神
出世=出生避世
失事=出事
脱手=出手
出版=出书
出面=出头具名
放洋=出洋
早春=初春
初次=初度
低级=初级
月朔=初一
初志=初衷
革职=除名
撤除=除去
荡瑕涤秽=除污去垢
大年夜=除夜
振弱除暴=锄强扶弱
蕴藏=储藏
积储=储蓄储存
络绎不绝=川流不息
穿房过屋=穿房入户
通报=传递
布道=传教
感染=传染
感化=传染感动
歌颂=传颂
外扬=传扬
翻译员=传译员
舟子=船夫
甲板=船面
船厂=船坞
船长=船主
喘气=喘息
首创=创始
奏乐=吹打
吹牛=吹法螺
沿门托钵=吹箫吴市
吹捧=吹嘘
演奏=吹奏
烟火=炊火
膳食=炊事
老迈=垂老
弥留=垂死
低头=垂头
馋涎欲滴=垂涎欲滴
东风=春风
春光=春景春色
南柯一梦=春梦一场
春情=春心
纯真=纯挚
朱唇皓齿=唇红齿白
巢毁卵破=唇亡齿寒
外号=绰号
词藻=词华
似义词=词目
词采=词藻
词翰=词章
善士=慈善家
乌鸟私情=慈乌反哺
词典=辞书
谈吐=辞吐
推却=辞谢
告老还乡=辞职归里
这次=此次
欲盖弥彰=此地无银三百两
别的=此外
越日=次日
序次=次序
次第=次序递次
砭骨=刺骨
刺眼=刺目耀眼
密查=刺探
照顾=赐顾帮衬
见教=赐教
赐予=赐赉
古往今来=从古到今
丛聚=簇集
逃匿=窜匿
窜犯=窜扰
敦促=催促
追讨=催讨
华而不实=脆而不坚
珠光宝气=翠绕珠围
乡人=村夫
村学=村校
村塾=村学
乡村=村庄
村落=村子
请安=存候
立足=存身
无法动弹=寸步难移
一男半女=寸男尺女
袒裼裸裎=寸丝不挂
寸晷=寸阴
寸心=寸衷
微暇=寸
拉拢=撮合
月老祠=撮合山
说话=措辞
步伐=措施
处置=措置
惊惶=错愕
丁宁=打发
罔顾情面=打狗不看主人面
审察=打量
冲破=打破
抽丰=打秋风
打搅=打扰
打顺风锣=打顺风旗
劫后余生=大难不死
除夕=大年节
年夜=大年夜
震怒=大怒
大权独揽=大权在握
高声=大声
洪流=大水
白痴=呆子
代庖=代办
价钱=代价
代劳=代庖
连累=带累
报酬=待遇
感德=戴德
图画=丹青
赤心=丹心
票据=单据
只身=单身
单位=单元
包管=担保
耽搁=担搁
延误=耽搁
胆大心细=胆大心小
心胆俱寒=胆破心惊
花旦=旦角
朝夕=旦夕
奏琴=弹琴
一矢之地=弹丸之地
百步穿杨=弹无虚发
转瞬之间=弹指之间
就地=当场
本地=当地
举棋不定=当机不断
方丈和尚=当家和尚
固然=当然
本事儿=当事者
当头棒喝=当头一棒
长驱直入=当者披靡
党魁=党首
勾魂摄魄=荡气回肠
浪子=荡子
词讼=刀笔
单刀直入=刀刀见血
刀光剑影=刀光血影
死生无惧=刀锯不辞
刀口上舔血=刀头舔血
引火线=导火线
反照=倒映
颠倒=倒置
作怪=捣蛋
捣蛋=捣鬼
得手=到手
哀悼=悼念
冷汗=盗汗
偷取=盗取
盗魁=盗首
作别=道别
原理=道理
羽士=道士
致谢=道谢
衣食计=稻粱谋
元配=德配
宽猛相济=德威并用
确当=的当
旗号=灯号
灯烛辉煌=灯火辉煌
字谜=灯谜
灯胆=灯泡
灯芯=灯炷
振臂一呼=登高一呼
登位=登基
成名术=登龙术
登岸=登陆
立地=登时
等候=等待
比及=等到
平分=等分
期待=等候
即是=等于
怒视=瞪眼
克己=低廉甜头
窃窃私议=低声密谈
低首下心=低头屈膝
淌下=滴下
仇人=敌人
嫡系=嫡派
蓝本=底本
舆图=地图
职位地方=地位
地理=地舆
文籍=典籍
仪式=典礼
悬挂=吊挂
悬梁=吊颈
除暴安良=吊民伐罪
垂纶=钓鱼
转班=调班
挑唆=调拨
跌宕=跌荡放诞
床上安床=迭床架屋
叮咛=丁宁
的一确二=丁一卯二
壮年=丁壮
订价=定价
意见=定见
定规=定例
定数=定命
订婚=定亲
放心=定心
定则=定章
治罪=定罪
抛弃=丢弃
到处奔跑=东奔西走
工具=东西
东洋=东瀛
笠帽=斗笠
打斗=斗殴
大氅=斗篷
自主国=独立国
单身=独身只身
一意孤行=独行其是
唯一=独一
独占=独有
鞭策=敦促
避债=躲债
海员=舵手
顿脚=跺脚
谣传=讹传
错漏=讹夺
抹杀=扼杀
威德兼施=恩威并用
恩德=恩义
恩仇=恩怨
膏泽=恩泽
童谣=儿歌
罢了=而已
而后=尔后
线人=耳目
以讹传讹=耳食之言
耳环=耳饰
谆谆教诲=耳提面命
再造之恩=二天之德
仲春=二月
他心=贰心
颁发=发表
发轫=发端
秘诀=法门
程序=法式
袈裟=法衣
熯=烦忙
洗净铅华=反璞归真
背叛=反水
回声=反响
平常=泛泛
出现=泛起
饭店=饭铺
领域=范畴
放荡不羁=放荡任气
纵火=放火
巡查=放哨
土匪=匪贼
谗言=诽语
人云亦云=吠形吠声
败坏=废弛
破除=废除
废物=废料
煞费苦心=费尽心血
分家=分居
分散=分离
别离=分袂
争分夺秒=分秒必争
阐发=分析
人缘=分缘
派遣=吩咐消磨
奋发蹈厉=奋发自强
奋勇当先=奋勇争先
气愤=愤恚
愤怒=愤慨
怨愤=愤懑
恼怒=愤怒
烟消火灭=风流云散
风马牛不相及=风马牛不相干
风马不接=风马牛不相及
风静=风止
风度翩翩=风姿潇洒
册封=封爵
猖獗=疯狂
簇拥=蜂拥
游戏人间=逢场作戏
化险为夷=逢凶化吉
投合=逢迎
钉扣子=缝扣子
讥笑=讽刺
作陪=奉陪
送上=奉上
馈赠=奉送
服侍=奉养
璧还=奉赵
刀头之蜜=佛口蛇心
空门=佛门
梵学=佛学
盗匪=伏莽
伏祈=伏乞
宓羲=伏羲
服罪=伏罪
导引=扶引
扶助=扶直
建设=扶植
浮皮蹭痒=浮皮潦草
首相=辅弼
子音=辅音
亏心=负心
卖力=负责
赞同=附和
配角=副角
帮手=副手
转变=改变
改弦易辙=改变方式
窜改=改动
大要=概略
观点=概念
干瘦=干瘪
快人快事=干脆爽快
寄父=干爹
兵戈=干戈
甘愿宁可=甘心
甘霖=甘雨
乐意=甘愿答应
感激不尽=感激涕零
大纲=纲目
高傲=高慢
高枕无忧=高枕而卧
安枕无忧=高枕无忧
高招=高着儿
高着=高作
学费=膏火
沃土=膏壤
腴膏=膏腴
切断=割断
盘据=割据
画饼充饥=割肉医疮
停顿=搁浅
笙歌=歌乐
赞美=歌颂
小我私家=个人
本位主义=个人主义
个别=个体
各有千秋=各有所长
各尽所能=各展其长
种种=各种
林林总总=各种各样
各不相谋=各自为政
准假=给假
赐与=给予
革除=根除
不可偻指算=更仆难数
夜阑人静=更深人静
愈甚=更甚
重生=更生
鼎新=更始
更次=更头
换衣=更衣
人为=工资
事情=工作
射手=弓手
弓鞬=弓套
公开场合=公共场所
公文=公函
公众=公家
公然=公开
正义=公理
义冢=公墓
打击=攻击
逗留=勾留
构思=构想
成仇=构怨
结构=构造
修筑=构筑
孤苦伶仃=孤家寡人
单刀赴会=孤军作战
株式会社=股份有限公司
坚如盘石=固若金汤
恪守=固守
顽强=固执
故友=故交
故宅=故居
未亡人=寡妇
关隘=关口
闭门塞窦=关门落锁
堂而皇之=冠冕堂皇
陈雷之契=管鲍之交
鄙见=管见
了如指掌=管窥蠡测
统领=管辖
管束=管制
来临=光降
赤脚=光脚
告白=广告
鹤寿=龟年
五十步笑百步=龟笑鳖无尾
范例=规范
光复=规复
规行矩步=规规矩矩
尊姓=贵姓
宝贵=贵重
王孙公子=贵族子弟
一枝独秀=桂林一枝
膜拜=跪拜
倒背如流=滚瓜烂熟
滚蛋=滚开
沸水=滚水
国学=国粹
王法=国法
停滞不前=裹足不前
浪潮=海潮
波浪=海浪
外洋=海外
海阪=海隅
水手=海员
惊诧=骇怪
抱病=害病
贻害不浅=害人不浅
畅快=酣畅
甜睡=酣睡
敦朴=憨厚
委曲求全=含垢忍辱
迷糊=含混
吞吐其词=含混其词
暗箭伤人=含沙射影
含笑九泉=含笑入地
尺牍=函牍
冷害=寒害
敝宅=寒家
寒战=寒噤
冷天=寒天
帆海=航海
航路=航线
佳肴=好菜
利益=好处
多事生非=好管闲事
优劣=好坏
昙花一现=好景不常
悦目=好看
善门难开=好人难做
好本领=好身手
慈悲心肠=好生之德
功德=好事
鲜花易谢=好事多磨
妙手=好手
晴天=好天
有始有终=好头不如好尾
宛如=好像
可笑=好笑
勤学=好学
美意=好意
摰友=好友
命令=号令
悲啼=号泣
浩大=浩荡
大难=浩劫
长吁=浩叹
斥责=呵
喝采=喝彩
饮酒=喝酒
归并=合并
通情达理=合情合理
称身=合身
适时=合时
配合=合营
适用=合用
合股=合资
互助=合作
多么=何等
何干=何关
作甚=何为
何必=何须
何故=何以
安在=何在
不值一提=何足道哉
蔼然可亲=和蔼可亲
友爱=和睦
协议=和谈
柔顺=和婉
调和=和谐
协议同意=和议
风雨同舟=和衷共济
河神=河伯
畏妻如虎=河东狮吼
河滨=河干
天河=河汉
河道=河流
河边=河畔
风平浪静=河清海晏
私货=黑货
玄色=黑色
暗盘=黑市
胡作非为=横行霸道
苛捐杂税=横征暴敛
弘大=宏大
后援=后盾
追悔不及=后悔无及
跋文=后记
恬不知耻=厚颜无耻
呼唤=呼喊
放肆荒唐=胡天胡地
颟顸=胡涂
梦想=胡想
髯毛=胡须
扯谈=胡诌
乱来=糊弄
豺狼=虎豹
十丈软红=花花世界
花草=花卉
园丁=花匠
花园=花圃
月下花前=花前月下
费钱=花钱
闭月羞花=花容月貌
口实=话柄
叙旧=话旧
发话器=话筒
挟恨=怀恨
吊唁=怀念
猜疑=怀疑
有身=怀孕
欢快=欢畅
变幻=幻化
幻境=幻梦
理想=幻想
阉人=宦官
官场=宦海
叫醒=唤醒
调班=换班
僻静=荒僻冷僻
荒淫无耻=荒淫无度
荒野=荒原
忙乱=慌乱
摆荡=挥动
招招手=挥挥手
洒泪=挥泪
笔底生花=挥洒自如
挥动=挥舞
接纳=回收
回击=回手
回顾=回首
回首=回首回头回忆
无法复生=回天乏术
转头=回头
悬崖勒马=回头是岸
旋里=回乡
聚餐=会餐
光临=惠临
灵魂=魂魄
忘八=混蛋
该死=活该
活结=活扣
活龙活现=活灵活现
灵敏=活络
生路=活门
生动=活泼
火化=火葬
同伴=伙伴
店员=伙计
炊事=伙食
庖丁=伙头
或谓=或曰
拨浪鼓=货郎鼓
货色=货品
得到=获得
赢利=获利
得胜=获胜
开罪=获罪
灾患丛生=祸不单行
祸端=祸根
病国殃民=祸国殃民
沧海横流=祸乱滔天
罪魁=祸首
祸根=祸胎
祸患=祸殃
心裁=机杼
珠圆玉润=肌理丰盈
消灭净尽=鸡犬不留
鸡飞狗跳=鸡犬不宁
一人得道=鸡犬升天
势如水火=积不相容
源远流长=积厚流光
激昂=激动慷慨
引发=激发
顶点=极点
淋漓尽致=极尽描摹
纵目=极目
死罪=极刑
綦重=极重
急忙忙=急巴巴
仓促=急急
快快当当=急急忙忙
抢救=急救
聚沙成塔=集腋成裘
枯寂=寂聊
肃然=寂然
寄存=寄放
义父=寄父
托足=寄迹
托身=寄身
投止=寄宿
寓意=寄意
更加=加倍
加快=加速
私人亲信=夹袋中人物
环堵萧然=家贫壁立
乡信=家书
萧墙之祸=家庭祸变
劳驾=驾临
驾驭=驾御
含沙射影=架词诬控
借贷=假贷
赝品=假货
倘使=假使
定居=假寓
冒充=假装
假仁假义=假装好人
移祸=嫁祸
嫁妆=嫁奁
妆奁=嫁妆
狡猾=奸刁
奸诈=奸滑
奸狡=奸猾
奸刁=奸狡
奸棍=奸徒
奸骗=奸淫
尖锐=尖利
刚正=坚毅刚烈
坚固=坚硬
坚忍=坚贞
傲雪欺霜=坚贞不屈
中断=间断
艰巨=艰难
晦涩=艰涩
深邃=艰深
多事之秋=艰屯之际
艰苦=艰辛
吞并=兼并
督工=监工
羁系=监禁
缧绁=监牢
监督=监视
闭口无言=缄口无言
沉默=缄默沉静
守口如瓶=缄舌闭口
节俭=俭约
逊色=减色
同窗夜语=剪烛西窗
查察=检察
检点=检束
查验=检验
校阅阅兵=检阅
演武厅=检阅场
校阅=检阅校对
简略=简单
翰札=简牍
简洁=简练
大略=简略
简易=简略单纯
扼要=简要
浅易=简易
看法=见地
识趣=见机
见风使舵=见机行事
见示=见教
施礼=见礼
跃跃欲动=见猎心喜
重色轻友=见色忘友
见地=见识
少见多怪=见识浅短
尝鼎一脔=见微知着
博古通今=见闻广博
收效=见效
贻笑大方=见笑于人
包涵=见原
见怪=见责
示知=见知
定都=建都
开国=建国
创建=建立
制作=建造
修建=建筑
一触即发=剑拔弩张
粗躯=贱躯
顽躯=贱体
康健=健康
垂垂=渐渐
蹂躏=践踏
残害=践踏糟踏
察言观色=鉴貌辨色
讲求=讲究
赏罚=奖惩
接壤=交界
交换=交流
交煎=交迫
话不投机=交浅言深
交界=交壤
融会=交融
比武=交手
瓜代=交替
生意业务=交易
行运=交运
征战=交战
吵骂=交谪
交错=交织
郊野=郊外
妩媚=娇媚
羞人答答=娇羞答答
浇薄=浇漓
自满=骄傲
骄贵=骄矜
高慢=骄气
心高气傲=骄气十足
宠儿=骄子
骄恣=骄纵
纠纷=胶葛
菲林=胶卷
刻舟求剑=胶柱鼓瑟
核心=焦点
着急=焦急
焦急=焦心
夫役=脚夫
角色=脚色
投机取巧=脚踏两船
脚迹=脚印行踪
剪刀=铰剪
搭钮=铰链
教养=教化
锻练=教练
西席=教师
课堂=教室
传授=教授
教学=教授教养
教导=教训
修养=教养
教诲=教育
阶层=阶级
囚徒=阶下囚
咸宜=皆宜
交班=接班
接手=接办
接班人=接棒人
打仗=接触
连续不断=接二连三
拂尘=接风
接受=接管
揭疮疤=揭隐私
发表=揭橥
简略节略=节减
着着失败=节节失利
节减=节略
节奏=节拍
骨气=节气
添枝加叶=节外生枝
节省=节约
联合=结合
完婚=结婚
交友=结交
缔盟=结盟
攀亲=结亲
壮实=结实
节余=结余
树怨=结怨
结实=结子
喜报=捷报
及锋而试=捷足先登
移多补少=截长补短
扣留=截留
不遗余力=竭尽全力
浇愁=解愁
开除=解雇
补救=解救
办理=解决
讲授=解说
乞贷=借钱
假使=借使
告贷=借债
借势=借重
借单=借字
托词=藉词
托故=藉端
藉槁=藉卉
女中丈夫=巾帼英雄
目前=今朝
今是昨非=今非昔比
以后=今后
本年=今年
此生=今生
昔不如今=今是昨非
本日=今天
琐屑较量=斤斤计较
黄灿灿=金灿灿
铜墙铁壁=金城汤池
弓足=金莲
款项=金钱
山盟海誓=金石之盟
城开不夜=金吾不禁
富可敌国=金玉满堂
玉液琼浆=金樽旨酒
补助=津贴
心曲=襟曲
牢牢=紧紧
紧急=紧要
严防=谨防
服膺=谨记
审慎=谨慎
谨慎=谨严
袖中神算=锦囊妙计
和盘托出=尽情宣露
止境=尽头
纵情=尽兴
效忠=尽忠
干劲=劲头
迩来=近来
隔壁=近邻
晚世=近世
接于眼前=近在眉睫
先进=进步前辈
一日千里=进步神速
出场=进场
包办=经办
管理=经管
颠末=经过
议决=经过议定
耐久=经久
担当=经受
经籍=经书
履历=经验
谋划=经营
经过=经由
通过=经由过程
糟糠=荆布
波折=荆棘
半壁江山=荆棘铜驼
草木惊心=惊弓之鸟
英华=精华
精炼=精华精辟
精神抖擞=精力充沛
简练=精练
精粹=精炼
细密=精密
佳构=精品
博识=精深
精力=精神
容光焕发=精神抖擞
萎靡不振=精神萎顿
神采奕奕=精神奕奕
精华=精髓
考究=精细精美
精通=精晓
字斟句酌=精益求精
戒备=警觉
警策=警励
鉴戒=警惕
保镳=警卫
警觉=警醒
警句=警语
警察=警员
比赛=竞赛
镇日=竟日
祭奠=敬拜
敬重=敬服
唯命是听=敬谨如命
花天酒地=酒绿灯红
猪朋狗友=酒肉朋友
酒坊=酒肆
醉翁=酒徒
酒菜=酒席
宿病=旧病
古道=旧道
往事=旧事
旧交=旧友
宿帐=旧帐
援军=救兵
扬汤止沸=救火投薪
消防员=救火员
济急=救急
接济=救济
浮水衣=救生衣
便是=就是
利市=就手
妥贴=就绪妥当
相敬如宾=举案齐眉
举行=举办
万众一心=举国同心
独一无二=举世无双
昂首=举头
闻一知十=举一反三
满堂=举座
巨子=巨擘
大奸=巨猾
大师=巨匠
富家=巨室
巨擘=巨头
大小=巨细
巨头=巨子
断绝=拒却
香烟=卷烟
怀念=眷念
家属=眷属
遗言=绝笔
悬崖=绝壁
百折不挠=绝不屈服
尽头=绝顶
发觉=觉察
掠夺=攫取
武备=军备
部队=军队
战功=军功
号角=军号
军器=军火
兵舰=军舰
兵力=军力
军械=军器
智囊=军师
羽书=军书
军火=军械
虎帐=军营
兵种=军种
平衡=均衡
均派=均摊
匀称=均匀
隽拔=俊拔
豪杰=俊杰
结束=竣事
开发=开辟
班师=凯旅
允承=慨诺
勘察=勘探
伐木=砍木
当作=看成
见解=看法
见机行事=看风使舵
监视=看管
瞥见=看见
急公好义=慷慨仗义
久旱=亢旱
拒捕=抗捕
难得=可贵
恐怖=可骇
适口=可口
可骇=可怕
可佩=可钦
可儿=可人
可信=可托
临渴掘井=渴而穿井
渴慕=渴仰
降服=克服
自制=克己
即日=克日
锐意=克意
画虎成犬=刻鹄类鹜
描画=刻画
受苦=刻苦
克日=刻期
期限=刻日
旅舍=客店
客长=客官
客堂=客厅
堆栈=客栈
讲义=课本
讲堂=课堂
拓荒=垦荒
耕作=垦植
谋害=坑害
空缺=空白
空腹=空肚
空屋=空房
栗栗不安=恐惧不安
忧惧=恐忧
控告=控诉
港口=口岸
众口称善=口碑载道
牙白口清=口齿伶俐
供词=口供
标语=口号
口传=口授
口味=口胃
口气=口吻
言犹在耳=口血未干
口儿=口子
广漠=宽敞豁达
杜康=狂药
何况=况且
举世无匹=旷代一人
空地=旷地
缺课=旷课
绝代=旷世
斗南一人=旷世一人
薄弱=亏弱
玉山颓倒=烂醉如泥
大醉=烂醉陶醉
谰言=滥调
来源=滥觞
朋比为奸=狼狈为奸
一败涂地=狼奔豕突
老夫=老汉
叫花子=老花子
老妇人=老太婆
齿豁头童=老态龙钟
老少=老小
老朽=老拙
老起面皮=老着脸子
告成=乐成
乐师=乐工
兴尽悲来=乐极生悲
音律=乐律
兴趣=乐趣
安分守己=乐天知命
高兴=乐意
乐土=乐园
打单=勒索
排山倒海=雷霆万钧
胸膜=肋膜
雷同=类似
隔岸观火=冷眼旁观
暗斗=冷战
变革=厘革
雠正=厘正
酒涡=梨涡
戏班=梨园
戏剧演员=梨园子弟
天经地义=理所当然
抱负=理想
孔武有力=力大无穷
力不胜任=力难胜任
脚钱=力钱
力弱=力衰
无能为力=力所不及
入木三分=力透纸背
力求=力图
力求进步=力图上进
力不从心=力有未逮
力图=力争
力求上进=力争上流
力图上进=力争上游
通书=历本
立即=立刻
扬名=立名
立品=立身
马上=立时
创新=立异
官样文章=例行公事
痛惜=怜惜
悯恤=怜恤
荡漾=涟漪
双宿双飞=莲开并蒂
连绵=联贯
团结=联结
联结=联络
携手=联袂
同盟=联盟
接洽=联系
关联=联系关系
遐想=联想
便宜=廉价
耿介=廉洁
酡颜=脸红
面目=脸孔
面庞=脸庞
表情=脸色
养成工=练习生
演练=练习训练
冶坊=炼坊
爱情=恋爱
依依不舍=恋恋不舍
风凉=凉快
草帽=凉帽
冷气=凉气
凉快=凉爽
立地书橱=两脚书橱
分身=两全
一箭双鵰=两全其美
两端=两头
秦晋之好=两姓之好
泪如泉涌=两眼汪汪
告终=了结
相识=了解
明晰=了了
了结=了却
远望=了望
清偿=了债
臆则屡中=料事如神
猜中=料中
传记=列传
各国=列国
枚举=列举
参加=列入
各位=列位
下等=劣等
次货=劣货
败行=劣行
节女=烈女
骄阳=烈日
火伞高张=烈日当空
义士=烈士
炎火=烈焰
缝隙=裂缝
裂缝=裂痕
毗邻=邻接
相近=邻近
邻居=邻人
各式各样=林林总总
临机处置=临机应变
戏子=伶人
灵巧=灵便
零散=零星
工头=领班
引港=领港
再娶=另娶
尚有=另有
滑冰=溜冰
传播=流传
弊端=流毒
万古长青=流芳千古
放逐=流放
堕泪=流泪
乐不思蜀=流连忘返
显露表露=流露透露
飘泊=流散
流畅=流通
过夜=留宿
把稳=留意
杏眼圆睁=柳眉倒竖
一乾二净=六根清净
魂飞魄散=六神无主
家畜=六畜
鸾翔凤翥=龙飞凤舞
生龙活虎=龙精虎猛
冰片=龙脑
龙马精神=龙腾虎跃
龙凤之姿=龙章凤姿
覆盖=笼盖
寒冬=隆冬
兴盛=隆盛
枯荣=隆替
鸿运=隆运
登科=录取
灌音=录音
任命=录用
途经=路过
门路=路线
途径=路子
勉力=戮力
合力攻敌=戮力同心
狗仗人势=驴蒙虎皮
路程=旅程
客居=旅居
游客=旅客
旅店=旅社
观光=旅行
巡回剧团=旅行剧团
经历=履历
赴任=履新
推行=履行
践言=履言
如约=履约
法规=律例
状师=律师
带领=率领
任性=率性
萧规曹随=率由旧章
忘八乌龟无赖=绿头巾
蛋白=卵白
椭圆形=卵形
庇护=卵翼
瞎搅=乱来
漫骂=乱骂
浊世=乱世
胡说=乱说
乱花=乱用
乱闯=乱撞
打劫=掠夺
拂面=掠面
抢夺=掠取
小坐=略坐
沉溺堕落=沦落
循环=轮回
照功行赏=论功行赏
讲价=论价
论述=论说
议论文=论说文
有夫之妇=罗敷有夫
吃尽当光=罗掘俱穷
坎阱=罗网
战死沙场=马革裹尸
劫夺一空=满目荒凉
浑身=满身
万无一失=满有把握
餍足=满足
诅咒=谩骂
轻慢=慢待
逐步=慢慢
不以为意=漫不经心
闲步=漫步
长空=漫空
会谈=漫谈
弥漫=漫溢
周游=漫游
伸张=蔓延
招摇撞骗=冒名行骗
鲁莽=冒失
同床异梦=貌合神离
不要紧=没关系
没关系=没紧要
籍籍无名=没没无闻
败兴=没趣
充公=没收
罗列=枚举
欢天喜地=眉飞色舞
端倪=眉目
眼去眉来=眉目传情
初月=眉月
媒人=媒妁
火油=煤油
通常=每每
逐日=每日
妍媸=美丑
雅观=美观
良图=美计
俏丽=美丽
竹苞松茂=美轮美奂
曲终奏雅=美满收场
仙颜=美貌
好梦=美梦
美好=美妙
隽誉=美名
美女=美男
玉人=美女
尤物=美人
丹青妙手=美术大师
佳话=美谈
鲜味=美味
佳誉=美誉
狐媚=媚惑
家世=门第
家声=门风
梦境=梦乡
空想=梦想
兰梦=梦熊
梦话=梦呓
垂危=弥留
横亘=绵亘
薄材=绵力
绵力=绵力薄材
源源不绝=绵绵不断
免除=免去
夺职=免职
口试=面试
面色苍白=面无人色
描绘=描画
刻画=描绘
形貌=描写
对准=瞄准
迷茫=渺茫
傲睨=渺视
奇策=妙计
大众文学=民间文学
国困民艰=民穷财尽
百孔千疮=民生凋敝
民风=民俗
大快人心=民怨沸腾
国蠹=民贼
大众=民众
哀怜=悯恻
矜恤=悯恤
名存实亡=名不副实
良庖=名厨
过甚其实=名过其实
求名求利=名利双收
名流=名士
花样=名堂
论理学=名学
嫡=明日
昭示=明示
来日诰日=明天
来日=明天将来
州官放火=明知故犯
刻骨铭心=铭肌镂骨
铭记=铭刻
下令=命令
命根子=命脉
定名=命名
偃蹇困穷=命运坎坷
运气=命运运限
掷中=命中
错爱=谬爱
乖谬=谬妄
临摹=摹仿
把戏=魔术
勾消=抹煞
着末=末了
季世=末世
末端=末尾
金兰交=莫逆交
茶青=墨绿
默默无言=默不作声
缄默=默然
静坐=默坐
图利=牟利
密谋=谋害
策划=谋划
碰面=谋面
钻营=谋求
行刺=谋杀
营生=谋生
找事=谋事
人定胜天=谋事在人
或人=某人
母大虫=母老虎
母财=母钱
丁忧=母丧
母范=母仪
目瞪口呆=木鸡之呆
木工=木匠
木柴=木料
木筏=木排
柴炭=木炭
板屋=木屋
桂花=木樨
星期四=木曜日
米已成炊=木已成舟
胸无点墨=目不识丁
目不斜视=目不转睛
目标=目的
理屈词穷=目瞪口呆
眼光=目光
目光如豆=目光短浅
孤陋寡闻=目光如豆
目光如电=目光如炬
眼见=目击
过目成诵=目即成诵
视力=目力
眼力=目力眼光
目次=目录
眼花撩乱=目迷五色
目染耳濡=目擩耳染
目若朗星=目若悬珠
手挥目送=目送手挥
眉目传情=目挑心招
目不邪视=目无流视
目无法纪=目无王法
一目十行=目下十行
眼花=目眩
目眩魂摇=目眩心花
目使颐令=目指气使
召募=募集
坟场=墓地
金口木舌=暮鼓晨钟
晚景=暮景暮年
老年末年=暮年
深秋=暮秋
打定主意=拿定主意
特长=拿手
内耗=内讧
要地本地=内陆
内=内乱
黑幕=内幕
底细=内情
水落石出=内情毕露
自察=内省
阁房=内室
表里=内外
心田=内心
忧心忡忡=内心不安
亵服=内衣
内涵=内在
内乱=内争
内里=内中
内人=内子
内争=内
何堪=那堪
那边=那里
那处=那里那边
进贡=纳贡
受贿=纳贿
乘凉=纳凉
以致=乃至
若何怎样=奈何
历久=耐久
刻苦=耐劳
耐烦=耐性
男儿膝下有黄金=男子汉大丈夫
两极=南北极
南边=南方
熏风=南风
黄粱一梦=南柯一梦
背道而驰=南辕北辙
出生入死=南征北战
难过=难得
惆怅=难过
难明=难解
不免=难免
灾黎=难民
难懂=难明
难熬难过=难受
困难=难题
瞠乎其后=难望项背
无法计算=难以估计
委决不下=难以决断
不可思议=难以想象
床头金尽=囊空如洗
席卷=囊括
瓮中鳖=囊中物
末路=恼
愤恨=恼恨
脑袋=脑壳
大腹便便=脑满肠肥
脑筋=脑子
打饥荒=闹饥荒
繁盛=闹热
生事=闹事
叫嚣=呐喊
新苗=嫩芽
可否=能否
醒目=能干
可以或许=能够
年景=年成
德高望重=年高德劭
年终=年关
腊鼓频催=年近岁终
大哥=年老
年事=年龄
年老=年迈
年轻=年青
年湮代远=年深日久
积年累月=年深月久
年岁=年事
年纪=年数
少不更事=年幼无知
年代=年月
念佛=念经
读书=念书
动机=念头
外家=娘家
母舅=娘舅
变成=酿成
兔死狗烹=鸟尽弓藏
莺啼燕语=鸟语花香
宁死不屈=宁当玉碎
太平=宁靖
寒门饮恨=牛衣对泣
豪饮=牛饮
九牛一毫=牛之一毛
摇摆=扭捏
旋转=扭转
屯子=农村
牧歌=农歌
庄家=农户
田舍=农家
田舍郎=农家子
耕具=农具
农民=农人
稼穑=农事
浓郁=浓烈
稠密=浓密
冶艳=浓艳
盛饰=浓妆
浓妆艳抹=浓装艳裹
饭桶=脓包
玩法=弄法
拈花惹草=弄柳拈花
赏月=弄月
梦熊=弄璋
仆众=奴婢
仆从=奴隶
奴婢=奴仆
卑视=奴视
卑躬屈膝=奴颜媚骨
女伶=女优
女中豪杰=女中丈夫
暴政=虐政
火锅=暖锅
脆弱=懦弱
西化=欧化
无意偶尔=偶然
逢场作戏=偶一为之
难舍难分=藕断丝连
爬行动物=爬虫类
登山=爬山
趴下=爬下
自由式泳法=爬泳
畏惧=怕惧
害臊=怕羞
击节称赏=拍案叫绝
泅水=拍浮
打门=拍门
鼓掌=拍手
照相=拍照
拍案叫绝=拍桌惊叹
倘佯=徘徊
场面=排场
列队=排队
倾轧=排挤
分列=排列
排解=排遣
翻江倒海=排山倒海
推门=排闼
分泌=排泄
排练=排演
付梓=排印
列阵=排阵
牌坊=牌楼
流派=派别
调派=派遣
牌照=派司
攀龙附凤=攀高结贵
扳话=攀话
接贵攀高=攀龙附凤
攀龙趋凤=攀龙附凤趋炎附势
阿谀奉承=攀龙趋凤
联姻=攀亲
交谈=攀谈
攀附=攀援
攀登=攀缘
遮道挽留=攀辕卧辙
剥削=盘剥
盘费=盘川
盘货=盘点
箕踞=盘蹲
盘缠=盘费
旅费=盘费盘川
心如乱麻=盘根错节
分裂=盘据
盘问=盘考
拨弄=盘弄
过人才略=盘盘大才
估计打算=盘算推算
查问=盘问
回旋=盘旋
般游=盘游
鉴别=判别
鉴定=判定
荒疏=抛荒
抛摆=抛撇
扬弃=抛弃
跑江湖=跑码头
药剂师=配药师
喷鼻=喷鼻香
歕饭=喷饭
喷鼻香=喷香
反攻=抨击
进犯=抨击打击
隆然=砰然
烹调=烹饪
通同作恶=朋比为奸
朋侪=朋友
澎湃=彭湃
蓬门=蓬荜
发达=蓬勃
蓬菖人=蓬户士
陋屋=蓬门
蓬葆=蓬头
蓬莱仙境=蓬瀛仙境
鸿猷=鹏图
汹涌=澎湃
品评=批评
指挥=批示
披荆棘=披荆斩棘
表露=披露
拖麻拽布=披麻带孝
披垂=披散
披星带月=披霜冒露
蓬首垢面=披头散发
披星戴月=披星带月
栉风沐雨=披星戴月
披览=披阅
劈头=劈脸
开端=劈头
没头没脑=劈头盖脸
轰隆=霹雳
京彩=皮蛋
表面=皮相
连接=毗邻
怠倦=疲乏
疲乏=疲倦
疲惫=疲困
委顿=疲劳
性情=脾气
脾气=脾性
片断=片段
单方面=片面
片面之词=片面之言
一语而解=片言立决
一鳞半爪=片纸只字
电影=片子
偏幸=偏爱
毛病=偏差
冷僻=偏僻
左袒=偏袒
方向=偏向
偏爱=偏心
偏心=偏幸
侧重=偏重
诈财=骗财
哄人=骗人
流落=漂泊
飘零=漂荡
英俊=漂亮
漂泊=漂流
烂帐=漂帐
飞舞=飘动
流浪=飘流
秋蓬=飘蓬
由由然=飘飘然
飘荡=飘扬
俊逸=飘逸
单子=票据
抛清=撇清
望见=瞥见
拼凑=拼集
冒死=拼命
缺少=贫乏
清贫=贫寒
布衣交=贫贱交
贫苦=贫穷困难
家徒四壁=贫无立锥
血虚=贫血
比年=频年
反复=频频
频繁=频仍
品行=品德
风致=品格
等级=品级
丰度=品貌
喝茶=品茗
聘任=聘用
安全=平安
安然无恙=平安无事
同辈=平辈
青云直上=平步青云
平明=平旦
平庸=平淡
持平立论=平心而谈
态度冷静=平心易气
夷易=平易
民=平易近
平易近人=平易近民
和颜悦色=平易近人
平正=平允
平坦=平展
屏蔽=屏障
萍泊=萍浮
不期而遇=萍水相逢
足迹=萍踪
恶妻=泼妇
凶暴=泼辣
地痞=泼皮
反水不收=泼水难收
胆大如斗=泼天大胆
火上加油=泼油救火
必不得已=迫不得已
如饥似渴=迫不及待
毒害=迫害
勒令=迫令
魂飞天外=魄散九霄
辨白=剖白
判定=剖断
解剖=剖解
表白=剖明
别析=剖判
剖判=剖释
五月=蒲月
空洞=朴陋
朴素=朴实
质朴=朴素
方正=朴直
朴实=朴质
率土同庆=普天同庆
大众化=普通化
出口成章=七步之才
东倒西歪=七颠八倒
忐忑不安=七上八下
手足无措=七手八脚
人多口杂=七言八语
泡茶=沏茶
老婆=妻子
黑暗=漆黑
门高莫对=齐大非偶
怪杰=奇人
独特=奇特
比方=歧
支路=歧路
邪路=歧途
祷告=祈祷
落魄=崎岖潦倒
马队=骑兵
将遇良才=棋逢敌手
对弈=棋战
旗鼓相当=旗敌相当
旗帜=旗号
马到成功=旗开马到
旗手=旗头
借款=乞贷
托钵人=乞丐
求和=乞降
讨饭=乞食
求助=乞助
开口=启齿
启示=启迪
发蒙=启蒙
缘由=启事
草拟=起草
动身=起程
早先=起初
出发点=起点
腾飞=起飞
刮风=起风
动怒=起火
发火点=起火点
发迹=起家
努力=起劲
最少=起码
拔锚=起锚
转机=起色
起家=起身
肇始=起始
发难=起事
断气=气绝
力气=气力
宇量=气量
心胸=气量气度
派头=气派
魄力=气势
威风凛凛=气势
意气相合=气味相投
气味=气息
气势=气焰
盛气凌人=气焰万丈
气度=气宇
高视睨步=气宇轩昂
高视阔步=气宇轩昂大摇大摆
吐故纳新=弃旧容新
搁置=弃捐
归天=弃世
弃文就武=弃文竞武
投笔从戎=弃文就武
弃捐=弃置
轮船=汽船
锅炉=汽锅
煤汽灯=汽油灯
泪流满面=泣如雨下
用具=器具
度量=器量
东西=器械
珍视=器重
适当=恰当
恰恰=恰好
碰巧=恰巧
正中下怀=恰如私愿
正是=恰是
洽商=洽谈
百般=千般
精益求精=千锤百炼
令媛=千金
如出一辙=千篇一律
光怪陆离=千奇百怪
盘根错节=千头万绪
流芳百世=千载扬名
千载难逢=千载一时
将就=迁就
搬家=迁居
拖延=迁延
迁徙=迁移
转动=迁移转变
牵涉=牵扯
前车可鉴=前车之鉴
出息=前程
滥觞=前导发轫
重作冯妇=前度刘郎
半途而废=前功尽弃
肩摩踵接=前后相接
前呼后拥=前呼后应
一呼百诺=前呼后拥
远景=前景
前赴后继=前仆后继
先驱=前驱
古人=前人
前线=前哨
宿世=前世
忖前思后=前思后想
条件=前提
前程=前途
未定之天=前途难料
鹏程万里=前途似锦
前去=前往
先哲=前贤
火线=前线
前夕=前夜
来龙去脉=前因后果
先兆=前兆
荷包=钱袋
金钱万能=钱可通神
赋税=钱粮
摇钱树=钱树子
银号=钱庄
闭口=钳口
左右夹攻=钳形进攻
胁迫=钳制
不通=欠亨
借据=欠据
短缺=欠缺
呵欠=欠伸
不当=欠妥
负债=欠债
偷偷的=悄悄的
互相研究=切磋琢磨
堵截=切断
牢记=切记
贴近=切近
逼近=切近亲近
隐语=切口
把脉=切脉
万万=切切
喁喁私语=切切私语
确切=切实
的确=切实其实
胆小=怯弱
胆怯=怯生生
交头接耳=窃窃私语
盗取=窃取
偷窥=窃视
暗笑=窃笑
扒手=窃贼
戚属=亲串
密切=亲切
亲切=亲热
敦睦=亲善
切身=亲身
婚事=亲事
知己=亲信
舟中敌国=亲信背叛
亲朋=亲友
支属=亲属
亲身=亲自
侵占=侵犯
侵犯=侵略
陵犯=侵扰进犯
沁人肺腑=沁人心脾
后来居上=青出于蓝
芳华=青春
青葱=青翠
两小无猜=青梅竹马
堪舆术=青鸟术
光天化日=青天白日
田鸡=青蛙
扶摇直上=青云直上
简便=轻便
侮慢=轻渎
微风=轻风
忽视=轻忽
下贱=轻贱
胆大妄为=轻举妄动
浮滑=轻狂
草率=轻率
率尔操觚=轻率下笔
骄易=轻慢
口不择言=轻诺寡言
柔柔=轻柔
藐视=轻视
蹑手蹑脚=轻手轻脚
轻浮=轻佻
轻微=轻细
明净=清白
归还=清偿
扫除=清除
平淡=清淡
盘点=清点
月白风清=清风明月
金科玉律=清规戒律
剿灭=清剿
朝晨=清早
谍报=情报
身不由己=情不自禁
情绪=情感
急中生智=情急智生
景象=情景
环境=情况
恋人=情人
情同骨肉=情同手足
感情=情绪
情谊=情意
来由=情由
无可非议=情有可原
庆祝=庆贺
穷源竟委=穷源溯流
美酒=琼浆
金风抽丰=秋风
天高气爽=秋高气爽
秋天景色=秋景
转蓬=秋蓬
秋日=秋天
监禁=囚系
供不应求=求过于供
责备=求全
拜鬼求神=求神拜鬼
爱才如命=求贤若渴
修业=求学
梦寐以求=求之不得
告急=求助
游泳=泅水
乐谱=曲谱
弯弯曲曲=曲曲折折
偏言=曲说
驱使=驱策
纳宠=娶妾
结婚=娶亲
蛀牙=龋齿
辞官=去官
客岁=去年
杳如黄鹤=去如黄鹤
披沙拣金=去伪存真
离职=去职
妙语=趣话
意见意义=趣味
妙闻=趣闻
骗局=圈套
第三者=圈外人
百口=全家
全军尽没=全军覆没
无一生还=全军尽没
端赖=全靠
尽力=全力
整年=全年
通盘=全盘
环球=全球
整日=全日
满身=全身
满是=全是
经心=全心
职权=权柄
权术=权谋
霸术=权术
权势巨子=权威
官僚=权要
权柄=权益
货币=泉币
墓穴=泉台
源头=泉源
病愈=痊愈
长短不一=犬牙交错
犬牙交错=犬牙相制
规劝=劝戒
奉劝=劝说
肇事=惹祸
触怒=惹恼
引人=惹人
高潮=热潮
激情亲切=热忱
热门=热点
人性=人道
地利人和=人地相宜
七嘴八舌=人多口杂
丰衣足食=人给家足
打胎=人工流产
钟灵毓秀=人杰地灵
老树枯柴=人老珠黄
黄包车=人力车
行同狗彘=人面兽心
性命=人命
气息奄奄=人命危浅
品德=人品
情面=人情
大家=人人
人间=人世
千算万算，不值天一划=人算不如天算
民气=人心
火食=人烟
职员=人员
因缘=人缘
不由得=忍不住
吃苦俭朴=忍苦
含垢忍辱=忍尤含诟
承认=认可
昼夜=日夜
夙夜匪懈=日夜勉
日记=日志
蛮夷=戎狄
军事机密=戎机
兵马=戎马
军队=戎行
军装=戎衣
为虎傅翼=如虎添翼
风起云涌=如火如荼
准期=如期
如丧考妣=如失父母
俯拾地芥=如拾草芥
如此=如斯
趋附者众=如蚁附膻
快意=如意
跬步不离=如影随形
如何是好=如之奈何
孔教=儒教
渴念=孺慕
童子=孺子
黄口孺子=乳臭未干
干娘=乳母
戏弄=辱弄
入国问俗=入境问禁
犯境=入寇
着迷=入神
中计=入网
定罪=入罪
囊空如洗=阮囊羞涩
得寸进尺=软土深掘
敲榨勒索=软硬兼取
刻意=锐意
修饰=润饰
三回九曲=三回九转
全军=三军
再三告诫=三令五申
宾客盈庭=三千珠履
成群结队=三五成群
鼎足之势=三足鼎立
拆伙=散伙
故里=桑梓
六神无主=丧魂失魄
漏网之鱼=丧家之犬
扰乱=骚动扰攘侵犯
打扫=扫除
虚有其表=色厉内荏
心醉情移=色授魂与
极峰=山顶颠峰
岩穴=山洞
猴子=山公
江山=山河
老虎=山君
野鹤闲云=山林隐士
庙门=山门
隐士=山人
山川=山水
山峰=山岳
盗窟=山寨
编削=删改
删节=删省
让开=闪开
闪耀=闪烁
约定=商定
店铺=商号
探讨=商量
谈判=商洽
商讨=商榷
贩子=商人
贸易=商业
商量=商酌
悬赏=赏格
赏光=赏脸
暂休=少憩
极少=少少
幼年=少小
片刻=少焉
罕用=少用
继述=绍述
尖兵=哨兵
叫子=哨子
奢侈=奢靡
费尽唇舌=舌敝唇焦
能言善辩=舌粲莲花
译员=舌人
长枪=蛇矛
本末倒置=舍本逐末
视死如归=舍身殉难
寒舍=舍下
设置装备摆设=设备
捏词=设辞
想法=设法主意
蜜意=深情
酷爱=深嗜
深奥=深邃
深沉=深邃深挚
深思熟虑=深图远虑
笃信=深信
深厚=深挚
极重繁重=深重
神色=神采
神采飞扬=神采奕奕
天造地设=神工鬼斧
怪诞=神怪
精神病=神经病
紧密=慎密
起伏=升沉
起落=升降
泰平承平=升平平安
造诣高深=升堂入室
仙游=升天
起用=升引
命途多舛=生不逢辰
天生=生成
人口=生齿
不学而能=生而知之
蛮人=生番
水果=生果
米饭钱=生活费
生涯=生活生计
生气勃勃=生机勃勃
生存=生计
活埋=生坑
新力量=生力军
恐怕=生怕
平生=生平
疾言厉色=声色俱厉
气吞山河=声势浩大
浩浩荡荡=声势赫赫
阵容=声威
声气=声息
荣誉=声誉
名震一时=声誉鹊起
张扬=声张
畜生=牲口
牲口=牲畜
压服=胜过
名胜=胜景
左券在握=胜券在握
准绳=绳尺
软梯=绳梯
绳索=绳子
免得=省得
省察=省检
扫墓=省墓
免却=省却
憬悟=省悟
省城=省垣
贤人=圣人
诏书=圣旨
哄传=盛传
隆重=盛大
大德=盛德
嘉会=盛会
日中则昃=盛极必衰
大怒=盛怒
妖装=盛饰
盛情=盛意
艳服=盛装
墓木已拱=尸骨早寒
尸骨=尸骸
登仙=尸解
老朽无能=尸居余气
尸体=尸首
遗体=尸体
越权代理=尸祝代庖
合浦珠还=失而复得
丧父=失怙
丢魂失魄=失魂落魄
冒失鬼=失魂鱼
火警=失火
失时=失机
迷途=失路
掉=失落
失色=失神
不慎=失慎
误事出事=失事
丧母=失恃
失察=失算
忘形=失态
扫兴=失望
发笑=失笑
讲错=失言
赋闲=失业
失礼=失仪
失信=失约
失窃=失贼
当面错过=失之交臂
失落=失踪
出错=失足
落空=失
先生=师长教师
效法=师法
墨客=诗人
行礼=施礼
发挥=施展
泰山压卵=狮子搏兔
湿漉漉=湿淋淋
好不容易=十分困难
安若泰山=十拿九稳
完美无缺=十全十美
旬日=十日
满目荒凉=十室九空
皮娇肉嫩=十指尖尖
不知去向=石沉大海
石工=石匠
白腊=石蜡
平地一声雷=石破天惊
煤油=石油
好友=石友
时不我待=时不再来
期间=时代
韶光=时光
马齿徒增=时光虚掷
明日黄花=时过境迁
时间=时候
及时=实时
实验=实行
着实=实在
十足=实足
拾人牙慧=拾人涕唾
寝食不安=食不甘味
门客=食客
食品=食物
言而不信=食言而肥
米珠薪贵=食玉炊桂
吃素=食斋
史书=史乘
史乘=史籍
亘古未有=史无前例
一口咬定=矢口不移
百发百中=矢无虚发
墟市=市集
时价=市价
街市商人=市井
屠狗之辈=市井之徒
奸商=市侩
市道市情=市面
市面=市情
商店=市肆
请愿=示威
斧正=示正
跑堂=侍者
当者披靡=势不可当
进退维谷=势成骑虎
半斤八两=势均力敌
权势=势力
曲直=是曲
这天=是日
因此=是以
刚才=适才
拔苗助长=适得其反
得当=适合
恰到好处=适可而止
写意=适意
实用=适用
刚巧=适值
开释=释放
佛教=释教
不共戴天=誓不两立
收获=收成
劳绩=收获
网络=收集
征求=收罗
收留=收容
难民营=收容所
摒挡=收拾
专心致志=收视反听
屏气凝神=收视返听
罢手=收手
回收=收受接管
紧缩=收缩
收据=收条
扫尾=收尾
停业=收歇
出入=收支
抄本=手本
腕表=手表
着手成春=手到回春
持志=守节
立室=受室
伏法=受刑
被骗=受愚
抱屈=受冤
怀胎=受孕
讲课=授课
倒持泰阿=授人以柄
娶妻=授室
付与=授予
给与=授与
消瘦=瘦削
切口=瘦语
书籍=书本
言不尽意=书不宣意
书柜=书橱
书柬=书函
字画=书画
册本=书籍
布告=书记
书箧=书箱
书函=书札
纾难=抒难
抒怀=抒情
要津=枢路
决死=殊死
疏通=疏浚
荒凉=疏落
抛荒=疏弃
疏导=疏通沟通
蔓延=舒展
运送=输送
丰年=熟年
置若罔闻=熟视无睹
老手=熟手在行
熟习=熟悉
内行=熟行
代理=署理
榜书=署书
小肚鸡肠=鼠肚鸡肠
方士=术士
法术=术数
防守=戍守
卫护=戍卫
守兵=戍卒
引颈就戮=束身待罪
整装=束装
陈说=述说
名高引谤=树大招风
立德=树德
结怨=树敌
树范=树模
建立=竖立
百姓=庶民
不可胜数=数不胜数
数量=数目
恒河沙数=数以万计
洗擦=刷洗
池塘=水池
迎刃而解=水到渠成
水点=水滴
磨铁成针=水滴石穿
冰炭不洽=水火不容
舶来品=水货
水费=水脚
河清海晏=水静无波
真相大白=水落石出
程度=水平
沟渠=水渠
如胶似漆=水乳交融
浮家泛宅=水上人家
水火倒悬=水深火热
海军=水师
不服水土=水土不服
水患=水灾
就寝=睡眠
寝衣=睡衣
趁便=顺便
安产=顺产
按序=顺次
说长道短=说三道四
评话=说书
谈笑=说笑
庞大无比=硕大无朋
法律=司法
管库=司库
经理=司理
管帐=司帐
第宅=私邸
便函=私函
偏见=私见
私情=私交
私家=私人
学堂=私塾
秘密交易=私相授受
屈打成招=私刑逼供
耳语=私语
私意=私衷
擅自=私自
思考=思虑
思想=思惟
头脑=思想
思路=思绪
须臾=斯须
沙哑=嘶哑
扯破=撕裂
枯燥=死板
诀别=死别
死有余辜=死不足惜
身后=死后
东山再起=死灰复然
生死=死活
尸谏=死谏
极力=死力
绝路末路=死路
毕命=死灭
暮气=死气
少气无力=死气沉沉
死而复活=死去活来
啮臂之交=死生之契
苦守=死守
殒命=死亡
断念=死心
执迷不悟=死心塌地
极刑=死刑
家徒壁立=四壁萧条
怪样子=四不像
跋山涉水=四处奔波
四序=四季
八方受敌=四面楚歌
四季=四时
七通八达=四通八达
手脚=四肢举动
太监=寺人
庙宇=寺院
奉养=伺候
侦察=伺探
彷佛=似乎
胶漆相投=似漆如胶
貌同实异=似是而非
豢养=饲养
残虐=肆虐
疏松=松散
放手=松手
松弛=松懈
包罗=搜罗
搜刮=搜索
征采=搜寻
复苏=苏醒
庸俗=俗气
陋儒=俗儒
庄严=肃静
庄重=肃肃
故旧=素交
向来=素来
素不相识=素昧生平
本心=素心
生性=素性
素愿=素志
顺手=随手
顺俗=随俗
比年不登=岁比不登
岁入=岁收
年头=岁首
年初=岁首年月
年龄=岁数
年底=岁尾
光阴=岁月
年末=岁终
称心快意=遂心如愿
破裂=碎裂
庶务=碎务
侵害=损害
鳞爪=琐闻
杂务=琐务
鸡零狗碎=琐屑零星
留意=属意
另日=他日
参考之资=他山之石
二心=他心
垮台=塌台
征伐=挞伐
脚踏实地=踏踏实实
大名=台甫
举高=抬高
仰面=抬头
反宾为主=太阿倒持
沧海微尘=太仓一粟
旷古=太古
宦官=太监
得陇望蜀=贪心不足
放开=摊开
铺平=摊平
口才=谈锋
发言=谈话
茶话会=谈话会
评论辩论=谈论
会商=谈判
言论=谈吐
言笑=谈笑
妙语横生=谈笑风生
交心=谈心
档册=檀案
案卷=檀卷
开阔=坦荡
装甲车=坦克车
坦白=坦率
直率=坦直
掩盖=袒护
赤身露体=袒裼裸裎
闲云野鹤=袒自若
怨嗟=叹恨
悲叹=叹伤
叹惋=叹惜
跳出火炕=逃出生天
兔脱=逃窜
避祸=逃难
避难=逃亡
越狱=逃狱
抱头鼠窜=逃之夭夭
逃脱=逃走
鸟语花香=桃红柳绿
感导=陶染
熏陶=陶冶
邓通之财=陶猗之富
迷恋=陶醉
诛讨=讨伐
托钵=讨饭
请援=讨救
说情=讨情
求饶=讨饶
腻烦=讨厌
乞援=讨援
讨债=讨帐
分外=特别
出力异常=特别卖力
专长=特长
彪炳=特出
特别=特殊
殊效=特效
特性=特征
腾踊=腾跃
腾云驾雾=腾云跨风
誊录=誊写
叫声=啼声
哭笑不得=啼笑皆非
提示=提醒
发起=提议
标题=题目
文体=体裁
天壤之别=天地之别
入夜=天黑
昏天黑地=天昏地暗
网罗密布=天罗地网
定命=天命
天南地北=天南海北
气候=天气
天气=天色
天年=天算
露台=天台
天国=天堂
法网恢恢=天网恢恢
率土归心=天下归心
天下升平=天下太平
世界大同=天下一家
海角天涯=天涯海角
本分=天职
上帝=天主
天佑=天助
资质=天资
枝节横生=添枝加叶
添油加醋=添枝接叶
田契=田单
挑衅=挑战
拣选=挑撰
层次=条理
条款=条目
条文=条则
便条=条子
跳班=跳级
舞蹈=跳舞
切题=贴题
知心=贴心
推心置腹=贴心贴腹
人中表表=铁中铮铮
驯伏=帖伏
民间文学=通俗文学
串通=通同
彻夜=通宵
焚膏继晷=通宵达旦
通达=通晓
通讯=通信
通畅=通行
关照=通知
公告=通知布告
搭档=同伴
惺惺相惜=同病相怜
戮力同心=同仇敌忾
同学=同窗
翅膀=同党
比量齐观=同等看待
夹杂=同化
朋友=同伙
同寅=同僚
随波逐流=同流合污
患难夫妻=同命鸳鸯
手足同心=同气连枝
怜悯=同情
煮荳燃萁=同室操戈
同亲=同乡
偕行=同行
同砚=同学
同行=同业
同道=同志
守望相助=同舟共济
同出一脉=同宗同气
浓云=彤云
更鼓敲尽=铜漏滴尽
宝穴=铜山
处女=童贞
同一=统一
放下屠刀=痛改前非
悔恨=痛恨
痛楚=痛苦
疼痛=痛苦悲伤
轸慕=痛念
酸心=痛心
切齿痛恨=痛心疾首
偷窃=偷盗
批红判白=偷天换日
鬼鬼祟祟=偷偷摸摸
高人一等=头角峥嵘
蓬头历齿=头童齿豁
条理分明=头头是道
头目=头子
谋利=投机
降服佩服=投降
当兵=投军
投机=投契
探亲=投亲
有所顾忌=投鼠忌器
礼尚往来=投桃报李
透彻=透辟
澈底=透澈
吐露=透露
表示=透露表现
泄漏天机=透露机密
突出=凸起
秃头=秃顶
托之空言=徒托空言
本地货=土产
地皮=土地
乡俗=土风
土鸡瓦犬=土牛木马
泥土=土壤
土气=土头土脑
土人=土着土偶
流露=吐露
呕吐=吐逆
扬扬得意=吐气扬眉
连合=团结
团圆=团聚
甲鱼=团鱼
火上浇油=推波助澜
革故鼎新=推陈出新
披肝沥胆=推诚相见
推许=推崇
推测=推想
倾销=推销
真心实意=推心置腹
推求=推寻
衰年=颓龄
颓废=颓丧
远而避之=退避三舍
退兵=退军
撤退=退却
逊位=退位
离席=退席
解甲归田=退役还乡
打趣=玩笑
淘气=顽皮
不知恩义=忘恩负义
忘却=忘怀
割肉医疮=望梅止渴
王谢=望族
危急=危机
骇人听闻=危言耸听
端坐=危坐
坚毅不拔=威武不屈
暖和=温煦
纸墨笔砚=文房四宝
掩罪藏恶=文过饰非
词句=文句
臭名=污名
浑浊=污浊
当年=昔时
扑灭=息灭
息款=息钱
相安无事=息事宁人
和解=息争
捐躯=牺牲
全部=悉数
淡薄=稀薄
希罕=稀疏
有数=稀有
门庭若市=熙熙攘攘
精致=细腻
金饰=细软
零碎=细碎
微小=细小
仔细=细心
小星=细姨
小雨=细雨
农历=夏历
夏季=夏日
品格清高=仙风道骨
瑶池=仙境
神仙=仙人
前锋=先锋
先辈=先进
预言家=先觉
老师=先生
天赋=先天
翻开=掀开
光显=鲜明
空隙=闲暇
散逸=闲逸
贤达=贤能
奉命=衔命
怀疑=嫌疑
闻达=显达
权贵=显贵
表现=显示
贵显=显要
明显=显着
险要=险峻
险路=险途
刁滑=险诈
当代=现代
实际=现实
征象=现象
如今=现在
近况=现状
限期=限日
限定=限制
沦陷=陷落
沉迷=陷溺
吉祥=祥瑞
纳福=享福
盗贼=响马
相应=响应
费尽心机=想方设法
缅怀=想念
领导=向导
落发=削发
跌价=削价
减少=削减
减弱=削弱
低沉=消沉
末节=小节
鄙视=小看
细姨=小老婆
巷子=小路
奶名=小名
鄙吝=小器
计无所出=小手小脚
幼童=小童
个人=小我
警惕=小心
胆小如鼠=小心谨慎
明白=晓畅
孝敬=孝顺
结果=效果
和缓=懈弛
怠惰=懈怠
问心无愧=心安理得
漫不经心=心不在焉
心折=心服
毫不勉强=心甘情愿
包藏祸心=心怀叵测
方寸已乱=心慌意乱
灰心丧气=心灰意懒
意气消沉=心灰意冷
心机=心计心情
闻风丧胆=心惊胆战
提心吊胆=心惊肉跳
内心=心里
生理=心理
心心相印=心领神会
心烦意乱=心乱如麻
得偿所愿=心满意足
平心静气=心平气和
痛澈心脾=心如刀割
聚精会神=心神专注
心伤=心酸
默算=心算
息息相通=心心相印
直肚直肠=心直口快
胸有定见=心中有数
费力=辛苦
辛劳=辛勤
酸楚=辛酸
复活=新生
消息=新闻
新鲜=新颖
月牙=新月
漫步=信步
佩服=信服
言三语四=信口雌黄
天花乱坠=信口开河
信任=信赖
信心=信念
信托=信任
名誉=信用
兴致索然=兴味索然
兴高采烈=兴致勃勃
孝服=凶服
暴虐=凶横
补缀=修理
补葺=修缮
羞涩=羞怯
羞耻=羞辱
作壁上观=袖手旁观
男子=须眉
浪费=虚耗
虚伪=虚假
浮名=虚名
假造=虚拟
衰弱=虚弱
卖弄=虚伪
客气=虚心
外强中干=虚有其表
假意周旋=虚与委蛇
矫揉造作=虚张声势
必要=需要
缓步=徐行
缓缓=徐徐
很多=许多
方兴未艾=旭日东升
媒介=序言
絮絮叨叨=絮絮不休
积蓄=蓄积
喧嚣=喧哗
闹热热烈繁华=喧闹
壮丽=绚丽
才高八斗=学富五车
门生=学生
济困解危=雪中送炭
含血喷人=血口喷人
血流成河=血流漂杵
平凡=寻常
探求=寻找
隆冬=严冬
冰冷=严寒
严厉=严峻
严格=严厉
严正=严肃
盛食厉兵=严阵以待
严明=严正
一针见血=言必有中
心口不一=言不由衷
执法如山=言出法随
出尔反尔=言而无信
百依百顺=言听计从
口是心非=言行相诡
酷热=炎热
夏天=炎天
酷暑=炎夏
遮蔽=掩蔽
掩饰笼罩=掩盖
养虎伤身=养痈遗患
约请=邀请
谎言=谣言
迢遥=遥远
句斟字嚼=咬文嚼字
痛心疾首=咬牙切齿
妙手回春=药到回春
针砭之语=药石之言
大概=也许
田野=野外
更阑=夜阑
一样平常=一般
不苟言笑=一本正经
明哲保身=一尘不染
束手无策=一筹莫展
一挥而就=一蹴而就
薪尽火灭=一刀两断
肯定=一定
岌岌可危=一发千钧
一向=一贯
一呼百应=一呼百诺
一下子=一会儿
一石二鸟=一举两得
屁滚尿流=一蹶不振
一得之愚=一孔之见
一清二楚=一览无余
连续=一连
一起=一路
江河日下=一落千丈
爱财如命=一毛不拔
一壁=一面
千篇一律=一模一样
一览无余=一目了然
贫无立锥=一贫如洗
趁热打铁=一气呵成
一尘不染=一乾二净
统统=一切
全无分别=一丘之貉
与日俱增=一日千里
等量齐观=一视同仁
金瓯无缺=一统天下
一扫而空=一网打尽
勇往直前=一往无前
别无长物=一无长物
一无可取=一无是处
一无所得=一无所获
空空如也=一无所有
一窍不通=一无所??
一直=一向
付之一笑=一笑置之
同心专心=一心
同心同德=一心一德
一声不响=一言不发
出言如山=一言九鼎
说一是一=一言为定
逐一=一一
独断专行=一意孤行
频频=一再
刀刀见血=一针见血
一孔之见=一知半解
不停=一直
同等=一致
大夫=医生
允从=依从
寄托=依靠
留恋=依恋
为人作嫁=依人篱下
维持原状=依样葫芦
践约=依约
移船就磡=移樽就教
忘记=遗忘
困惑=疑心
嫁祸他人=以邻为壑
曩昔=以前
以牙还牙=以眼还眼
依附=倚赖
义军=义师
当仁不让=义无反顾
任务=义务
理直气壮=义正辞严
媾和=议和
马首是瞻=亦步亦趋
非常=异常
他日=异日
贰言=异议
他乡=异域
外族=异族
烦闷=抑郁
轻而易举=易如反掌
良朋=益友
料想=意料
不测=意外
弦外之音=意在言外
求学=肄业
马马虎虎=因陋就简
随机应变=因时制宜
由于=因为
相沿=因袭
抱残守缺=因循守旧
剖腹藏珠=因噎废食
隐隐=隐约
答允=应承
应付裕如=应付自如
当机立断=应机立断
合时=应时
贤明=英明
头等=优等
好处=优点
精良=优良
精美=优美
柔嫩=优柔
优越=优胜
上风=优势
优秀=优异
富足=优裕
厚待=优遇
良好=优越
苦恼=忧?
哀愁=忧愁
伤时感事=忧国忧民
忧愁=忧闷
忧心如捣=忧心如焚
担心=忧郁
交情=友谊
防患未然=有备无患
对症下药=有的放矢
口碑载道=有口皆碑
百辞莫辩=有口难言
名不副实=有名无实
鄙意=愚见
屈曲=愚昧
呆笨=愚拙
同流合污=与世浮沉
颠三倒四=语无伦次
苦口婆心=语重心长
财宝=玉帛
忧郁=郁闷
愁闷=郁悒
预支=预付
初赛=预赛
宽裕=裕如
罹难=遇难
月尾=月底
玉轮=月亮
月晦=月终
小序=弁言
搏命=拚命
遵奉=禀承
天禀=禀赋
摈弃=摒除
料理=摒挡
张口结舌=瞠目结舌
殚精竭虑=殚智竭力
恬淡=澹泊
沾光=叨光
讨教=叨教
雕琢=砥砺
擎天一柱=砥柱中流
注视=谛视
细听=谛听
顶峰=巅峰
不断=赓续
黑白=诟谇
讲和=媾和
车水马龙=毂击肩摩
都门=毂下
伫候=鹄候
伫立=鹄立
盲人=瞽者
点头=颔首
点头答应=颔首应承
通同一气=沆瀣一气
白发苍颜=皓首苍颜
斥骂=诃斥
学校=黉舍
不求甚解=囫囵吞枣
区区=戋戋
洗雪=湔雪
困阻=蹇滞
姣美=姣好
俊俏=姣美
胶葛=轇轕
鹤立鸡群=佼佼不群
太息=嗟叹
觉悟=憬悟
判然不同=迥然不同
急变=遽变
丝毫=涓滴
雕刻=镌刻
淘汰=镌汰
恳=镌谕
清高=狷介
形影相吊=孓然一身
其后=厥后
冷炙=馂余
夫妇=伉俪
劳军=犒军
赏赐=犒赏
打盹=瞌睡
敬慎=恪慎
选派=遴派
挑选=遴选
践踏=辚轹
凝听=聆听
淹没消灭=泯没
淹灭=泯灭
明器=冥器
猛然=蓦地
眼珠=眸子
衣冠禽兽=沐猴而冠
假日=沐日
吸风饮露=沐雨栉风
洗浴=沐浴
过去=曩昔
内疚=忸怩
惭愧=忸捏
膝行=匍匐
靡靡之音=濮上之音
细长=颀长
庸人自扰=杞人忧天
鳃鳃过虑=杞天之忧
富丽=绮丽
年轻貌美=绮年玉貌
绮绮子弟=绮襦纨裤
休憩=憩息
吝啬=悭吝
图章=钤记
虔诚=虔敬
经纪=掮客
缠绵=缱绻
杀害=戕害
角楼=谯楼
干瘪=憔悴
坚持不懈=锲而不舍
蹀躞=踥蹀
独居=茕居
消灭=祛除
鸦雀无声=阒寂无声
改过=悛改
柔弱=荏弱
沥血以誓=歃血为盟
闲雅=娴雅
芳泽=芗泽
种植=栽种
重版=再版
再见=再会
不屈不挠=再接再厉
活着=在世
临时=暂时
停息=暂停
同意=赞成
称赞=赞美
讨厌=憎恶
痛恨=憎恨
奉送=赠送
踏实=扎实
安营=扎营
压迫=榨取
择要=摘要
局促=窄小
借主=债主
志得意满=沾沾自喜
浓厚=粘稠
展望=瞻望
仰望=瞻仰
鸡犬不留=斩草除根
极新=崭新
霸占=占领
占据=占有
败北=战败
克服=战胜
兵士=战士
百战百胜=战无不胜
小心翼翼=战战兢兢
伸开=张开
默不作声=张口结舌
宣扬=张扬
蛇头鼠眼=獐头鼠目
狐假虎威=仗势欺人
慷慨解囊=仗义疏财
抵挡=招架
雇用=招聘
申雪=昭雪
调集=召集
如法泡制=照猫画虎
还是=照样
起始=肇端
掩藏=遮蔽
遮掩=遮盖
掩蔽=遮掩
半数=折半
赔本=折本
扣头=折扣
折衷=折中
冬眠=蛰伏
如许=这样
纯洁=贞洁
箴规=针砭
刑警队=侦缉队
夺取=争取
抢先=争先
辩论=争执
征请=征聘
展开=睁开
如日方升=蒸蒸日上
救济=拯救
整理=整顿
划一=整齐
团体=整体
支持=支撑
付出=支付
分崩离析=支离破碎
着名=知名
功成身退=知难而退
满足=知足
兰交=至好
至好=至交
嫡亲=至亲
顽固不化=至死不悟
同舟共济=志同道合
制定=制订
订定=制定
礼服=制服
成品=制品
克制=制止
结局=终局
莳植=种植
浩繁=众多
众寡不敌=众寡悬殊
异口同声=众口一词
大庭广众=众目睽睽
众口纷纭=众说纷纭
众擎易举=众志成城
骨干=主干
重要=主要
方丈=住持
停止=住手
留宿=住宿
助势=助威
助桀为虐=助纣为虐
表明=注解
解释=注释
刊出=注销
状态=状况
寻求=追求
跟随=追随
定时=准时
答应=准许
卓识=卓见
杰出=卓越
袒自若=自得其乐
主动=自动
苟且偷安=自甘堕落
目空一切=自高自大
挺身而出=自告奋勇
自身难保=自顾不暇
本身=自己
自发=自觉
自诩=自夸
自感汗颜=自愧弗如
独立=自力
自主=自立
得意洋洋=自鸣得意
孤芳自赏=自命不凡
发奋图强=自强不息
天然=自然
自若=自如
自尽=自杀
白手起家=自食其力
利欲熏心=自私自利
自坠陷阱=自投罗网
自大=自信
自作掩饰=自圆其说
怨天尤人=自怨自艾
志愿=自愿
从容=自在
自负=自尊
统共=总共
统辖=总揽
泛论=总论
直通=纵贯
构造=组织
故国=祖国
本籍=祖籍
先人=祖先
研讨=钻研
末了=最后
近来=最近
开始=最先
终极=最终
罪过=罪恶
罪不容诛=罪该万死
罪行=罪过
罪大恶极=罪孽深重
犯人=罪人
恶行=罪行
咎由自取=罪有应得
灯红酒绿=醉生梦死
出声=作声
冷眼旁观=坐观成败
管中窥豹=坐井观天
下狱=坐牢
过后行兵=坐失良机
诚惶诚恐=坐卧不安
不劳而获=坐享其成
漫谈=座谈
办事=做事
造作=做作
AV女优=***
奸淫=***
来回=往返
赶快=赶紧
寒冷=严寒
坚决=果断
恐惊=恐惧
暗香=幽香
荒芜=荒凉
得意=自得
农夫=农民
慈祥=慈爱
毕竟=究竟
陶醉=沉醉
苏醒=清醒
增援=支援
关键=要害
疲劳=疲惫
惊疑=惊奇
审视=审阅
愣住=停住
眺望=远望
准备=预备
耀眼=刺眼
光芒=光线
洁白=雪白
惊奇=惊异
中央=中心
严肃=严厉
容易=轻易
智慧=聪明
气魄=气势
希奇=希罕
家景=家境
思索=思考
镇定=镇静
严峻=严肃
糟蹋=糟践
奇怪=希奇
掌握=把握
犹如=如同
徐徐=渐渐
凝视=注视
环游=周游
模仿=模拟
无边无涯=无边无际
迷迷糊糊=模模糊糊
情不自禁=不由自主
赏心悦目=心旷神怡
斗志昂扬=意气风发
好人=hao人
爸爸=粑粑
邮件=email
含混=含糊
反映=反应
部署=安排
诋毁=毁谤
毒辣=狠毒
基础=基本
范畴=范围
辨别=分辨
抵牾=抵触
矛盾=抵触
抵御=抵抗
田地=地步
境地=地步
地域=地区
位置=地位
推翻=颠覆
装点=点缀
玷辱=玷污
惦念=惦记
凋落=凋零
凋谢=凋零
更换=调换
替换=调换
落伍=掉队
诱饵=钓饵
理解=懂得
了解=懂得
领会=懂得
摇动=动摇
动听=动人
恐吓=恫吓
吓唬=恫吓
峻峭=陡峭
专制=独裁
专断=独断
负气=赌气
渡过=度过
判断=断定
确定=断定
葬送=断送
对比=对照
对立=对峙
腐化=堕落
蜕化=堕落
敲诈=讹诈
欺诈=讹诈
狠毒=恶毒
恩情=恩惠
恩典=恩惠
宣布=发布
动员=发动
颤抖=发抖
哆嗦=发抖
挖掘=发掘
发现=发明
会面=会见
会晤=会见
汇合=会合
会意=会心
阴暗=昏暗
浑朴=浑厚
憨厚=浑厚
憨实=憨厚
淳厚=浑厚
淳朴=浑厚
紊乱=杂乱
杂乱=混乱
混淆=混杂
混合=混杂
活气=活力
生机=活力
生气=活力
活跃=活泼
火炬=火把
开朗=豁达
根基=基础
冲动=激动
感动=激动
剧烈=激烈
猛烈=激烈
饥馑=饥荒
灵活=机动
机遇=机会
时机=机会
机警=机灵
机智=机灵
秘密=机密
积聚=积累
积压=积存
缴获=缉获
吸取=汲取
聚集=集合
聚拢=集合
迫切=急切
急迫=急切
匆忙=急忙
慌忙=急忙
辣手=棘手
技能=技巧
技术=技巧
手法=伎俩
记录=记载
起誓=发誓
赌咒=发誓
懊恼=烦恼
焦躁=烦躁
忙碌=繁忙
繁华=繁荣
滋生=繁殖
孳生=繁殖
对抗=反抗
反水=反叛
叛变=反叛
反应=反响
犯罪=犯法
计划=方案
便利=方便
典范=范例
方式=方法
办法=方法
法子=方法
芬芳=芳香
防范=防备
提防=防备
妨害=妨碍
阴碍=妨碍
拜访=访问
造访=访问
走访=访问
仿制=仿造
放纵=放荡
放肆=放纵
废弃=放弃
飞驰=飞奔
飞翔=飞行
微薄=菲薄
毁谤=诽谤
诬蔑=诽谤
废止=废除
费神=费心
劳神=费心
分说=分辩
分别=分辨
分辩=分辨
分离=分别
分手=分别
剖析=分析
纷纭=纷纷
纷繁=纷纷
缭乱=纷乱
凌乱=纷乱
嘱咐=吩咐
叮嘱=吩咐
掩饰=粉饰
斗争=奋斗
发奋=奋发
发愤=奋发
丰厚=丰富
丰硕=丰富
丰产=丰收
丰登=丰收
风度=风采
风姿=风度
风韵=风度
景致=风景
景色=风景
风尚=风气
风俗=风气
幽默=风趣
盛行=风行
流行=风行
锐利=锋利
犀利=锋利
讥讽=讽刺
讥诮=讽刺
挖苦=讽刺
阿谀=奉承
恭维=奉承
否认=否定
应付=敷衍
浮浅=肤浅
浅薄=肤浅
显现=浮现
呈现=浮现
急躁=浮躁
遵从=服从
顺从=服从
抚育=抚养
培植=扶植
糜烂=腐烂
腐败=腐烂
腐蚀=腐化
邻近=附近
左近=附近
从属=附属
隶属=附属
富裕=富饶
强盛=富强
挂花=负伤
挂彩=负伤
温习=复习
庞杂=复杂
繁杂=复杂
改造=改革
革新=改革
改进=改良
改善=改良
矫正=改正
清洁=干净
洁净=干净
干涸=干枯
干预=干涉
情愿=甘心
觉得=感到
感觉=感到
感激=感谢
感触=感想
感慨=感叹
坚强=刚强
纲要=纲领
高明=高超
昂扬=高昂
高下=高低
上下=高低
文雅=高雅
高等=高级
高档=高级
高贵=高尚
精深=高深
精湛=高深
愉快=高兴
兴奋=高兴
告知=告诉
奉告=告诉
歌唱=歌颂
讴歌=歌颂
隔断=隔绝
格局=格式
款式=格式
基本=根本
依据=根据
改换=更换
功夫=工夫
公正=公平
公道=公平
功能=功效
功绩=功劳
功勋=功??
恭顺=恭敬
供应=供给
提供=供给
赡养=供养
共识=共鸣
勾勒=勾画
勾搭=勾结
引诱=勾引
购买=购置
估量=估计
孤独=孤单
激励=鼓励
煽动=鼓动
怂恿=鼓动
怪僻=古怪
旧居=故居
家乡=故乡
参谋=顾问
执拗=固执
顽固=固执
牵挂=挂念
察看=观察
欣赏=观赏
关怀=关心
关切=关心
贯串=贯穿
通例=惯例
常规=惯例
习用=惯用
光亮=光明
光彩=光荣
荣耀=光荣
辉煌=光辉
渊博=广博
辽阔=广阔
宽阔=广阔
普遍=广泛
规则=规矩
范围=规模
归咎=归罪
狡辩=诡辩
阴谋=诡计
领土=国土
国是=国事
国度=国家
公民=国民
人民=国民
武断=果断
细致=过细
进程=过程
历程=过程
过分=过火
过头=过火
过甚=过火
多余=过剩
惧怕=害怕
恐惧=害怕
模糊=含混
豪迈=豪放
豪爽=豪放
奢华=豪华
激情=豪情
英雄=好汉
消耗=耗费
耗损=耗费
号令=号召
召唤=号召
和气=和睦
和蔼=和气
和善=和气
协调=和谐
适合=合适
适宜=合适
及格=合格
黑洞洞=黑沉沉
黑魆魆=黑沉沉
黑糊糊=黑沉沉
黑黝黝=黑沉沉
权衡=衡量
衬托=烘托
雄伟=宏伟
巨大=宏大
庞大=宏大
忽略=疏忽
解脱=摆脱
挣脱=摆脱
拜会=拜见
拜望=拜见
拜谒=拜见
公布=颁布
随同=伴随
伴同=伴随
辅助=帮助
爪牙=帮凶
走狗=帮凶
模范=榜样
楷模=榜样
表率=榜样
薄暮=傍晚
黄昏=傍晚
嘉奖=褒奖
夸奖=褒奖
包括=包含
包孕=包含
包抄=包围
坚持=保持
维持=保持
保留=保存
维护=保护
捍卫=保卫
颐养=保养
珍重=保重
丰满=饱满
负疚=抱歉
埋怨=抱怨
悲痛=悲哀
悲恸=悲哀
凄凉=悲凉
凄切=悲凉
凄惨=悲凉
卑劣=卑鄙
卑下=卑贱
低贱=卑贱
低微=卑微
微贱=卑微
奔驰=奔跑
奔腾=奔跑
奔忙=奔走
奔波=奔走
原来=本来
原本=本来
原先=本来
本领=本事
实质=本质
本色=本质
爱惜=爱护
珍惜=爱护
倾慕=爱慕
羡慕=爱慕
喜好=爱好
喜欢=爱好
喜爱=爱好
嗜好=爱好
暗昧=暧昧
含糊=暧昧
安宁=安定
宁静=安静
恬静=安静
平静=安静
清静=安静
寂静=安静
幽静=安静
支配=安排
安逸=安适
抚慰=安慰
劝慰=安慰
平稳=安稳
安眠=安息
清闲=安闲
悠闲=安闲
安顿=安置
安放=安置
暗杀=暗害
暗算=暗害
隐藏=暗藏
潜藏=暗藏
阴影=暗影
依照=按照
遵照=按照
龌龊=肮脏
恶浊=肮脏
激战=鏖战
后悔=懊悔
忏悔=懊悔
扼守=把守
操纵=把持
控制=把持
空费=白费
枉费=白费
白皙=白净
陈设=摆设
陈列=摆设
原形=本相
真相=本相
天性=本性
愚笨=笨拙
愚蠢=笨拙
瓦解=崩溃
强迫=逼迫